##########
#A     # #
# ### ## #
#   #    #
### ######
#        #
# ###### #
#      #B#
##########
