######################
#      A#  #        B#
# ####### ######## ###
#    #           #   #
#### # ######### ### #
#              ##    #
##############    # ##
#        #     ####  #
## ####### ###########
#  ## ####    ###### #
# ###      ########  #
#     ####          ##
######################